12345678901234567890123456789012
+---------+---------+----------+
|    #              #          |
|    #    | \       |          |
|##|abc|###  \      |  +   +   |
|  +---+  |         |   + +    |
|  |      |   369   #    #    #|
|--+ + +--+      /  |   + +    |
|    | |  |     /   |  +   +   |
| |  +-+  |  +--    |          |
|*|       #  |                 |
+---------+--+------+----------+