012345678901234567890
+-------+-----------+
|       |           | 
| +---+ |   -----   |
|   |   |           |
|   + +-|---     ---|
|     |             |
|   +-+ |           |
|       |           |
+-------+-----------+
