12345678901234567890123456789012
+---------+---------+----------+
|      ##################      |
|      #                #      |
|      #   G  A  M  E   #      |
|      #                #      |
|      #   O  V  E  R   #      | 
|      #                #      |
|      ##################      |  
|                              | 
|           (y.2020)           |
+---------+---------+----------+