+-------+
|   #   |
| |abc| |
| +---+ |
| |     |
|-+ + +-|
|   | | |
| | +-+ |
|*|     |
+-------+