12345678901234567890123456789012
+------+----------------+------+
|      ##################      |
|      |                |      |
|      |      KEY2      |      |
+--##--+     L0Xn3$     +--##--+
|      |                |      |
|      |                |      |
|      |           ##   |      | 
|      |          #     |      |
|      |   ###   #      |      |  
+------+~~~~~~~~~~~~~~~~+------+