012345678
+-------+
|       |
| +---+ |
|   |   |
|   + +-|
|     |  
|   +-+ |
|       |
+-------+
